1.360.000	t rf e s e m i l s e s e n t a m i l
10	d j e s
17.175.000	m i l s e t e o s e t i s i ng k o m i l
25	d o s m i l k
28	b eI n t i o tS o
314	t rf e s k a t o rf s e
40	k w a rf e n t a
425.000	k w a t b eI n t i s i ng k o m i l
466.000	k w a t s eI s m i l s eI s j e n t o s m i l
50.000	i ng k w e n t a m i l
54	s i ng k rf s e
7.000	s j e t e m i l
8	o tS o
a	a
abierta	a b j e rf t a
abrir	a b rf i rf
abstenerse	a b s t e n e rf s e
abstuvo	a b s t u b o
acatar	a k a t a rf
acerca	a s e rf k a
actuar	a k t w a rf
acuerdo	a k w e rf D o
además	a D e m a+ s
adrián	a D rf j a+ ng
aduciendo	a D u s j e n d o
afortunadamente	a f o rf t u n a D a m e n t e
agua	a G w a
ahora	a o rf a
ahí	a i+
al	a l
alargaron	a l a rf G a rf o ng
alegaciones	a l e G a T j o n e s
alguna	a l G u n a
allí	a L i+
alta	a l t a
alternativa	a l t e rf n a t i b a
amb	a m b
animal	a n i m a l
aniversario	a n i b e rf s a rf j o
anti-corrupción	a n t i k o r u p s j o+ ng
anti-soborno	a n t i s o b o rf n o
análisis	a n a+ l i s i s
aplicación	a p l i k a s j o+ ng
aplicar	a p l i k a rf
aprobación	a p rf o b a s j o+ ng
aprobada	a p rf o b a D a
aprobadas	a p rf o b a D a s
aprobar	a p rf o b a rf
aprobaron	a p rf o b a rf o ng
aprobó	a p rf o b o+
aproximadamente	a p rf o k s i m a D a m e n t e
aquellos	a k e L o s
aquí	a k i+
artículos	a rf t i+ k u l o s
así	a s i+
ataque	a t a k e
atrás	a t rf a+ s
aumentar	aU m e n t a rf
autonomía	aU t o n o m i+ a
autonómicas	aU t o n o+ m i k a s
autonómico	aU t o n o+ m i k o
avisado	a b i s a D o
ayuntamiento	a L u n t a m j e n t o
ayuntamientode	a L u n t a m j e n t o D e
ayuntamientos	a L u n t a m j e n t o s
año	a n~ o
bastante	b a s t a n t e
berenjenal	b e rf e n x e n a l
bienes	b j e n e s
bienestar	b j e n e s t a rf
brigada	b rf i G a D a
buenas	b w e n a s
bueno	b w e n o
burjabike	b u rf x a b aI k
burjassot	b u rf x a s s o t
básicamente	b a+ s i k a m e n t e
caja	k a x a
calles	k a L e s
casa	k a s a
casi	k a s i
católica	k a t o+ l i k a
cautelar	k aU t e l a rf
celebrar	s e l e b rf a rf
celebró	T e l e b rf o+
cemef	s e m e f
central	s e n t rf a l
centros	T e n t rf o s
cerrar?¿cómo	s e r a rf k o+ m o
cifra	T i f rf a
ciudadanos	s j u D a D a n o s
ciudadanía	s j u D a D a n i+ a
colegios	k o l e x j o s
comentado	k o m e n t a o
comentar	k o m e n t a rf
comentarios	k o m e n t a rf j o s
comisión	k o m i s j o+ ng
como	k o m o
competencias	k o m p e t e n T j a s
completo	k o m p l e t o
compromís	k o m p rf o m i+ s
común	k o m u+ ng
con	k o ng
concejalas	k o n T e x a l a s
concejales	k o n T e x a l e s
conjuntamente	k o n x u n t a m e n t e
constitución	k o ng s t i t u s j o+ ng
continuos	k o n t i n w o s
contra	k o n t rf a
control	k o n t rf o l
convoque	k o ng V o k e
cortar	k o rf t a rf
corts	k o rf t s
cosa	k o s a
crear	k rf e a rf
creemos	k rf e e m o s
creen	k rf e e ng
creímos	k rf e i+ m o s
cual	k w a l
cuales	k w a l e s
cuando	k w a n d o
cuenta	k w e n t a
cuestiones	k w e s t j o n e s
culto	k u l t o
cultura	k u l t u rf a
cumple	k u m p l e
cumpliendo	k u m p l j e n d o
cuándo	k w a+ n d o
cómo	k o+ m o
da	d a
dar	d a rf
darle	d a rf l e
datos	d a t o s
de	d e
debates	d e b a t e s
debatieron	d e b a t j e rf o ng
debatir	d e b a t i rf
debatirla	d e b a t i rf l a
debatió	d e b a t j o+
debe	d e b e
decidir	d e T i D i rf
decidió	d e T i D j o+
decir	d e T i rf
decirlo	d e T i rf l o
dedicados	d e D i k a D o s
dedicar	d e D i k a rf
del	d e l
delegada	d e l e G a D a
demora	d e m o rf a
demás	d e m a+ s
desde	d e z D e
despedidos	d e s p e D i D o s
deuda	d eU D a
deudas	d eU D a s
diferencia	d i f e rf e ng s j a
diferentes	d i f e rf e n t e s
digamos	d i G a m o s
dio	d j o
disuelta	d i s w e l t a
diversos	d i b e rf s o s
dotar	d o t a rf
duda	d u D a
dudas	d u D a s
duplicar	d u p l i k a rf
déficit	d e+ f i s i t
día	d i+ a
días	d i+ a s
e	e
económica	e k o n o+ m i k a
económicos	e k o n o+ m i k o s
edificios	e D i f i T j o s
educación	e D u k a s j o+ ng
educativa	e D u k a t i b a
educativos	e D u k a t i b o s
efectivamente	e f e k t i b a m e n t e
ejemplo	e x e m p l o
ejercer	e x e rf s e rf
el	e l
ellas	e L a s
empalme	e m p a l m e
empresa	e m p rf e s a
en	e ng
encarga	e n k a rf G a
energética	e n e rf x e+ t i k a
entidades	e n t i D a D e s
entonces	e n t o n T e s
entre	e n t rf e
entregar	e n t rf e G a rf
equipo	e k i p o
es	e s
esa	e s a
esas	e s a s
escrito	e s k rf i t o
ese	e s e
eso	e s o
espera	e s p e rf a
esquerra	e s k e r a
esta	e s t a
estaba	e s t a b a
estabilidad	e s t a b i l i D a
estas	e s t a s
estatal	e s t a t a l
este	e s t e
esto	e s t o
estudiarlas	e s t u D j a rf l a s
está	e s t a+
están	e s t a+ ng
estén	e s t e+ ng
etcétera	e t s e+ t e rf a e+ t e rf a
euros	eU rf o s
excepción	e s T e p T j o+ n
exclusión	e s k l u s j o+ ng
exentos	e s e n t o s
exigir	e k s i x i rf
explicar	e k s p l i k a rf
extinción	e s t i n T j o+ n
extinta	e k s t i n t a
falta	f a l t a
faltaba	f a l t a b a
fase	f a s e
favorablemente	f a b o rf a b l e m e n t e
favorables	f a b o rf a b l e s
fecha	f e tS a
felicitamos	f e l i s i t a m o s
fianza	f j a n T a
fomento	f o m e n t o
forma	f o rf m a
formado	f o rf m a D o
fue	f w e
fuera	f w e rf a
fueron	f w e rf o ng
función	f u n T j o+ n
gastos	G a s t o s
general	x e n e rf a l
generalitat	x e n e rf a l i t a t
gente	x e n t e
gestionar	x e s t j o n a rf
gobierno	G o b j e rf n o
gravemente	G rf a b e m e n t e
grupo	G rf u p o
ha	a
habitual	a b i t w a l
había	a b i+ a
habíamos	a b i+ a m o s
hace	a s e
hacemos	a s e m o s
hacer	a s e rf
hacia	a s j a
han	a ng
hasta	a s t a
hay	aI
haya	aI a
he	e
hecho	e tS o
hemos	e m o s
hicieron	i s j e rf o ng
hicimos	i T i m o s
históricas	i s t o+ rf i k a s
hizo	i s o
iba	i b a
ibi	i b i
iglesia	i G l e s j a
impago	i m p a G o
impuesto	i m p w e s t o
incluir	i ng k l w i rf
incluya	i ng k l u L a
incluyó	i ng k l u L o+
incorporarlas	i ng k o rf p o rf a rf l a s
incurrir	i ng k u r i rf
indemnizar	i n d e m n i T a rf
informadas	i ng f o rf m a D a s
informe	i ng f o rf m e
infraestructura	i n f rf a e s t rf u k t u rf a
ingresos	i n g rf e s o s
iniciado	i n i s j a D o
inmuebles	i ng m w e b l e s
innecesaria	i n n e T e s a rf j a
inspección	i ng s p e k s j o+ ng
inste	i ng s t e
intentar	i n t e n t a rf
intentos	i n t e n t o s
interesantes	i n t e rf e s a n t e s
intereses	i n t e rf e s e s
intervenir	i n t e rf b e n i rf
invadiendo	i ng V a D j e n d o
inversiones	i m V e rf s j o n e s
investigación	i ng V e s t i G a s j o+ ng
jurídico	x u rf i+ D i k o
juste	x u s t e
justificación	x u s t i f i k a T j o+ n
la	l a
labor	l a b o rf
lado	l a D o
largo	l a rf G o
las	l a s
lastrando	l a s t rf a n d o
le	l e
legislación	l e x i z l a T j o+ n
les	l e s
ley	l eI
leyes	l e L e s
libertad	l i b e rf t a
limpieza	l i m p j e T a
llegar	L e G a rf
lleva	L e b a
lo	l o
local	l o k a l
lomce	l o m s
los	l o s
luego	l w e G o
luz	l u s
líneas	l i+ n e a s
madrid	m a D rf i
mal	m a l
manera	m a n e rf a
mantenimiento	m a n t e n i m j e n t o
medio	m e D j o
mejor	m e x o rf
mes	m e s
meses	m e s e s
meternos	m e t e rf n o s
meterse	m e t e rf s e
metro	m e t rf o
millones	m i L o n e s
minutos	m i n u t o s
mociones	m o T j o n e s
moción	m o s j o+ ng
modificaciones	m o D i f i k a T j o n e s
muchas	m u tS a s
municipio	m u n i s i p j o
muy	m u j
más	m a+ s
nada	n a D a
necesarias	n e s e s a rf j a s
necesario	n e s e s a rf j o
ninguna	n i n g u n a
ningún	n i ng g u+ ng
nivel	n i b e l
no	n o
nos	n o s
nosotros	n o s o t rf o s
noviembre	n o b j e m b rf e
nuestra	n w e s t rf a
nuestras	n w e s t rf a s
nuestro	n w e s t rf o
nueva	n w e b a
nuevos	n w e b o s
o	o
obligada	o b l i G a D a
obras	o b rf a s
octubre	o k t u b rf e
opinión	o p i n j o+ ng
oponga	o p o n g a
oportuno	o p o rf t u n o
optó	o p t o+
orden	o rf D e ng
ordenanza	o rf D e n a n T a
organismo	o rf G a n i z m o
organismos	o rf G a n i z m o s
os	o s
otra	o t rf a
otras	o t rf a s
otro	o t rf o
otros	o t rf o s
paelleros	p a e L e rf o s
pagado	p a G a D o
pagar	p a G a rf
pagara	p a G a rf a
pago	p a G o
paliar	p a l j a rf
para	p a rf a
paralizado	p a rf a l i T a o
parece	p a rf e s e
parecen	p a rf e T e n
parte	p a rf t e
partido	p a rf t i D o
partidos	p a rf t i D o s
pasado	p a s a D o
paseo	p a s e o
pasó	p a s o+
pedimos	p e D i m o s
pedía	p e D i+ a
pensamos	p e n s a m o s
periodo	p e rf j o D o
perjudicar	p e rf x u D i k a rf
pero	p e rf o
pesar	p e s a rf
pida	p i D a
piensen	p j e ng s e ng
plan	p l a ng
plazo	p l a s o
pleno	p l e n o
pobreza	p o b rf e s a
poco	p o k o
poder	p o D e rf
podrían	p o D rf i+ a ng
policía	p o l i T i+ a
político	p o l i+ t i k o
políticos	p o l i+ t i k o s
popular	p o p u l a rf
por	p o rf
porque	p o rf k e
portavoz	p o rf t a b o s
posicione	p o s i s j o n e
pp	p e p e
preguntamos	p rf e G u n t a m o s
preguntar	p rf e G u n t a rf
preguntas	p rf e G u n t a s
presencia	p rf e s e ng s j a
presentada	p rf e s e n t a D a
presentado	p rf e s e n t a D o
presentamos	p rf e s e n t a m o s
presione	p rf e s j o n e
prespuestos	p rf e s p w e s t o s
presupuestaria	p rf e s u p w e s t a rf j a
presupuestario	p rf e s u p w e s t a rf j o
primero	p rf i m e rf o
problemas	p rf o b l e m a s
proceso	p rf o s e s o
profesorado	p rf o f e s o rf a o
prohibición	p rf o i b i s j o+ ng
promesa	p rf o m e s a
propia	p rf o p j a
propias	p rf o p j a s
propio	p rf o p j o
propuesta	p rf o p w e s t a
propuestas	p rf o p w e s t a s
proveedores	p rf o b e e D o rf e s
próximamente	p rf o+ k s i m a m e n t e
próximo	p rf o+ s i m o
psoe	s o e
pueblo	p w e b l o
pueden	p w e D e ng
pues	p w e s
puntos	p u n t o s
pública	p u+ b l i k a
que	k e
quede	k e D e
queja	k e x a
queremos	k e rf e m o s
quería	k e rf i+ a
queríamos	k e rf i+ a m o s
quitar	k i t a rf
qué	k e+
rajolar	r a x o l a rf
rajoy	r a x oI
ratas	r a t a s
razón	r a T o+ n
reactivación	r e a k t i b a s j o+ ng
receso	r e s e s o
recordemos	r e k o rf D e m o s
recurso	r e k u rf s o
recursos	r e k u rf s o s
redes	r e D e s
rehabilitación	r e a b i l i t a s j o+ ng
requiera	r e k j e rf a
respondió	r e s p o n d j o+
restringe	r e s t rf i n x e
resuelto	r e s w e l t o
resumen	r e s u m e ng
retirada	r e t i rf a D a
retiramos	r e t i rf a m o s
retirar	r e t i rf a rf
retiraron	r e t i rf a rf o ng
retirase	r e t i rf a s e
retiró	r e t i rf o+
riesgo	r j e z G o
rifirrafe	r i f i r a f e
ruegos	r w e G o s
salió	s a l j o+
se	s e
sean	s e a ng
segunda	s e G u n d a
sentido	s e n t i D o
ser	s e rf
serie	s e rf j e
servicio	s e rf b i s j o
servía	s e rf b i+ a
señaló	s e n~ a l o+
si	s i
sigue	s i g e
sin	s i ng
sistema	s i s t e m a
situación	s i t w a T j o+ n
sobre	s o b rf e
social	s o T j a l
socialista	s o s j a l i s t a
solamente	s o l a m e n t e
son	s o ng
soterramiento	s o t e r a m j e n t o
soy	s oI
su	s u
subiremos	s w i rf e m o s
suciedad	s u s j e D a
superávit	s u p e rf a+ b i t
supuesto	s u p w e s t o
suscitaron	s u s i t a rf o ng
suspendido	s u s p e n d i D o
suspendió	s u s p e n d j o+
suspensión	s u s p e n s j o+ n
también	t a m b j e+ ng
tanto	t a n t o
tarde	t a rf D e
tenemos	t e n e m o s
tenéis	t e n e+ i s
tenían	t e n i+ a ng
terreno	t e r e n o
tiene	t j e n e
tirar	t i rf a rf
toda	t o D a
todas	t o D a s
todavía	t o D a b i+ a
todo	t o D o
todos	t o D o s
total	t o t a l
totes	t o t e s
trabajadores	t rf a b a x a D o rf e s
trabajándose	t rf a b a x a+ n d o s e
tres	t rf e s
tráfico	t rf a+ f i k o
técnicos	t e+ k n i k o s
típico	t i+ p i k o
un	u ng
una	u n a
unanimidad	u n a n i m i D a
unida	u n i D a
uno	u n o
unos	u n o s
uso	u s o
uso?¿quién	u s o k j e+ ng
utilización	u t i l i s a s j o+ ng
utilizar?¿cómo	u t i l i T a rf k o+ m o
va	b a
van	b a ng
varios	b a rf j o s
vean	b e a ng
vecinas	b e s i n a s
vecinos	b e s i n o s
vemos	b e m o s
ver	b e rf
verdad	b e rf D a
viable	b j a b l e
viene	b j e n e
vigilar	b i x i l a rf
vigilar?¿quién	b i x i l a rf k j e+ ng
visto	b i s t o
viven	b i b e ng
vivienda	b i b j e n d a
volver	b o l b e rf
votamos	b o t a m o s
votos	b o t o s
votó	b o t o+
voy	b oI
vuelvan	b w e l b a ng
vídeo	b i+ D e o
y	j
ya	L a
última	u+ l t i m a
últimamente	u+ l t i m a m e n t e
último	u+ l t i m o
únicamente	u+ n i k a m e n t e
